11111111111111111111111111111111111111111111111111111
10011110111100100101111000000000000000000000000000001
10010000100000100101001000000000000000000000000000001
10011100111100100101110000000000000000000000000000001
10010000100000100101001000000000000000000000000000001
10010000111100111101000100000000000000000000000000001
10000000000000000000000000000000000000000000000000001
10000000000000000000011111000000000000000000000000001
10000000000000000000110001100000000000000000000000001
10000000000000000000100E00100000000000000000000000001
10000000000000000000110001100000000000000000000000001
10000000000000000000010C01000000000000000000000000001
10000000000000000000001010000000000000000000000000001
10000000000000000000001011111000000000000000000000001
10000000000000000000001000001000000000000000000000001
10000000000000000000001111101000000000000000000000001
10000111000000000000000000101000000000000000011100001
10000000000000000000000000101000000000000000000000001
10000000000000000000000000101000000000000000000000001
10000000000000000000000000101000000000000000000000001
10000000000000000000000000101000000000000000000000001
100C000000CCCCCC0000000000000000000000000000000000001
100C00000000000C0000000000000000000000000000000000001
100C0C000000000C0000000000000000000000000000000000001
100C0C0000CCCCCC0000000000000000000000000000000000001
100CCCCC00C000000000000P00000000000000000000000000001
10000C0000CCCCCC0000000000000000000000000000000000001
11111111111111111111111111111111111111111111111111111
