111111111111
1P00000000C1
100000100001
100001E10001
111111111111