111111111111
1P00000001C1
100000000011
100001E10001
111111111111