11111111111111111111
100000000000000C0001
11000100001000010001
10100100000010100011
1P0000000C00C0000001
100010000000000C0001
100000000C0001000101
10010001000000000001
10000000000000C10101
1100000111000001E101
11111111111111111111
