1111111111111111111111111111111111111111111111111111111111
1001111011110010010111100000000000000000000000000000111111
1001000010000010010100100000000000000000000000000000111111
1001110011110010010111000000000000000000000000000000111111
1001000010000010010100100000000000000000000000000000111111
1001000011110011110100010000000000000000000000000000111111
1000000000000000000000000000000000000000000000000000111111
1000000000000000000001111100000000000000000000000000111111
1000000000000000000011000110000000000000000000000000111111
10000000000000000000100E0010000000000000000000000000111111
1000000000000000000011000110000000000000000000000000111111
10000000000000000000010C0100000000000000000000000000111111
10000000000000000000001010000000000000000000000000000000C1
1000000000000000000000101111100000000000000000000000111111
1000000000000000000000100000100000000000000000000000111111
1000000000000000000000111110100000000000000000000000111111
1000011100000000000000000010100000000000000001110000111111
1000000000000000000000000010100000000000000000000000111111
1000000000000000000000000010100000000000000000000000111111
1000000000000000000000000010100000000000000000000000111111
1000000000000000000000000010100000000000000000000000111111
100C000000CCCCCC000000000000000000000000000000000000111111
100C00000000000C000000000000000000000000000000000000111111
100C0C000000000C000000000000000000000000000000000000111111
100C0C0000CCCCCC000000000000000000000000000000000000111111
100CCCCC00C000000000000P0000000000000000000000000000111111
10000C0000CCCCCC000000000000000000000000000000000000111111
1111111111111111111111111111111111111111111111111111111111
1111111111111111111111111111111111111111111111111111111111